60
20
************************************************************
*                                               *          *
* * ******* **** ************ ****************** * ******* *
* * * *     *               * *        *       * * * *   * *
* * * * ******** ************ * ****** * ***** * * * * * * *
* *            *            * *        *     * * *     *** *
* ********* ************* *** ******** ******* * ********* *
*           *                            *     *           *
* ******************* * * * * * ********** *************** *
*                  ** * * * * ************ ************    *
* ****** *** ****** * * * * * **                        ** *
* ******* ** *** ** * * *** * ********** * *************** *
*           *    ** * *     * *        * * *   *           *
* **** **** * ***** * ******* * ** *** * * * * * **** **** *
* **** **** *       *         *    ***   * * * * *       ***
*           ****************************** * *** **** **** *
* ** * * ** *                                  * *      ** *
* ** * **** ***************** ****************** **** **** *
*                                                   *      *
************************************************************
