60
20
************************************************************
** ************   ****************************      ********
** ************** **************************** ******* *****
**                       **   *******************      *****
***** *********** ****** **** ******              **** *****
***** *********** ****** **   ****** ************ **** *****
***** *********     **** **** ****** ************ **** *****
***** ********* ******** **** ******       ****** ****    **
************    ******** **** ************ ****** ******* **
****  ******* ********** **** ************ ****** ******* **
**** ******** **********                    ***** *******  *
**** ******** ***********************  ********** ****     *
**** ******** ******                  **********  **********
**** ******** ****** **************************** ***   ****
**                **    ************************* *** * ****
*************  ******** *******                   ***** ****
**    ******* ********* ******* ***************** ***** ****
** ** *******                   *****************       ****
** **      ********************         ********************
************************************************************
